6	9 	64 	64
0	1	2	3	2	7	1	5	6
5	8	9	10	11	2	1	12	6
5	1	7	2	2	13	8	14	6
15	1	2	2	3	2	4	5	6
16	8	10	9	11	11	10	5	6
17	17	17	17	17	17	17	17	18