1 0 0 35 -1 183 100 16 32 4 205
2 0 0 35 -1 313 165 16 32 2 205
3 0 1 35 -1 442 100 16 32 2 205
4 0 1 35 -1 58 216 16 32 12 205
5 0 2 35 -1 568 288 16 32 2 205
6 0 0 35 -1 696 227 16 32 11 205
7 0 0 35 -1 826 291 16 32 2 205
8 0 1 35 -1 954 291 16 32 1 205
9 0 1 35 -1 1080 216 16 32 2 205
10 0 2 35 -1 1280 291 16 32 4 205
11 0 1 35 -1 1335 216 16 32 1 205
12 0 1 35 -1 1498 222 16 32 1 205
13 0 0 22 -1 1518 0 18 128 0 200
14 0 1 22 -1 1518 254 18 98 0 200
15 0 2 22 -1 1438 224 98 30 0 200
16 0 2 22 -1 1344 286 64 33 0 200
17 0 1 22 -1 0 159 255 33 0 200
18 0 2 22 -1 256 223 353 33 0 200
19 0 2 22 -1 0 292 1536 33 0 200