1 0 0 35 -1 183 132 16 32 4 205
2 0 0 35 -1 313 197 16 32 2 205
3 0 1 35 -1 442 132 16 32 2 205
4 0 1 35 -1 58 248 16 32 12 205
5 0 2 35 -1 568 320 16 32 2 205
6 0 0 35 -1 696 259 16 32 11 205
7 0 0 35 -1 826 323 16 32 2 205
8 0 1 35 -1 954 323 16 32 1 205
9 0 1 35 -1 1080 248 16 32 2 205
10 0 2 35 -1 1280 323 16 32 4 205
11 0 1 35 -1 1335 248 16 32 1 205
12 0 1 35 -1 1498 254 16 32 1 205
13 0 0 22 -1 1518 127 18 128 0 200
14 0 1 22 -1 1518 352 18 98 0 200
15 0 2 22 -1 1438 254 98 30 0 200
16 0 2 22 -1 1344 319 64 33 0 200
17 0 1 22 -1 0 192 255 33 0 200
18 0 2 22 -1 256 256 353 33 0 200
19 0 2 22 -1 0 354 1536 33 0 200