1 0 0 35 -1 1463 284 8 17 6 205
2 0 0 35 -1 1337 315 8 17 10 205
3 0 1 35 -1 1210 315 8 17 2 205
4 0 1 35 -1 1080 315 8 17 9 205
5 0 2 35 -1 953 315 8 17 4 205
6 0 0 35 -1 824 315 8 17 2 205
7 0 0 35 -1 698 315 8 17 2 205
8 0 1 35 -1 571 315 8 17 3 205
9 0 1 35 -1 444 315 8 17 2 205
10 0 2 35 -1 184 157 8 17 4 205
11 0 0 35 -1 314 184 8 17 1 205
12 0 0 22 -1 0 360 520 32 0 200
13 0 1 22 -1 520 360 1040 32 0 200
14 0 2 22 -1 1040 360 1536 32 0 200
15 0 2 32 -1 1370 300 50 10 0 202