1 3 8 31 -1 167 260 32 64 3 201
2 7 8 31 -1 431 260 32 64 1 201
3 11 8 31 0 685 260 32 64 1 201
4 15 8 31 0 930 260 32 64 3 201
5 19 8 31 0 1197 260 32 64 2 201

6 0 10 22 0 0 322 1536 64 0 200

7 22 8 32 0 1400 260 32 64 0 202