1 0 0 35 0 167 280 32 64 3 205
2 0 0 31 0 431 260 32 64 1 201
3 0 1 31 0 685 260 32 64 4 201
4 0 1 31 0 930 260 32 64 3 201
5 0 2 31 0 1197 260 32 64 2 201
6 0 0 22 0 0 325 1536 64 0 200
7 0 2 32 0 1400 260 32 64 0 202
