1 0 0 35 -1 1454 294 16 32 6 205
2 0 0 35 -1 1337 326 16 32 10 205
3 0 1 35 -1 1208 326 16 32 2 205
4 0 1 35 -1 1080 326 16 32 9 205
5 0 2 35 -1 954 326 16 32 4 205
6 0 0 35 -1 824 326 16 32 2 205
7 0 0 35 -1 698 326 16 32 2 205
8 0 1 35 -1 570 326 16 32 3 205
9 0 1 35 -1 440 326 16 32 2 205
10 0 2 35 -1 186 296 16 32 4 205
11 0 0 35 -1 312 167 16 32 1 205
12 0 0 22 -1 1475 220 60 220 0 200
13 0 1 22 -1 1543 318 194 68 0 200
14 0 2 22 -1 1470 219 66 220 0 200
15 0 2 32 -1 512 30 897 30 0 202
16 0 2 32 -1 831 287 66 32 0 202
17 0 2 32 -1 575 287 66 32 0 202
18 0 2 32 -1 64 287 66 32 0 202
19 0 2 32 -1 255 384 1090 32 0 202
20 0 2 32 -1 126 352 130 32 0 202
21 0 2 32 -1 192 223 194 32 0 202
22 0 2 32 -1 0 384 66 352 0 202
23 0 2 32 -1 0 32 128 32 0 202