1 0 0 35 -1 167 260 16 32 2 205
2 0 0 31 -1 431 260 16 32 4 205
3 0 1 35 0 685 260 16 32 7 205
4 0 1 35 0 930 260 16 32 12 205
5 0 2 31 0 1197 260 32 64 2 201
6 0 0 22 0 0 322 1536 64 0 200
7 0 2 32 0 1400 260 32 64 0 202
