1 0 0 22 0 0 353 512 32 0 200
2 0 0 22 0 450 0 64 384 0 200
3 0 0 22 0 352 225 97 32 0 200
4 0 0 22 0 62 160 256 32 0 200
5 0 0 22 0 32 130 32 124 0 200
6 0 0 22 0 0 0 32 258 0 200
8 0 0 35 0 55 	338 0 0 4 201
9 0 2 32 0 300 0 32 32 0 202