1 0 0 22 0 0 353 512 32 0 200
2 0 0 22 0 450 0 64 384 0 200
3 0 0 22 0 352 225 97 32 0 200
4 0 0 22 0 62 160 256 32 0 200
5 0 0 22 0 32 130 32 124 0 200
6 0 0 22 0 0 0 32 258 0 200
7 0 0 32 0 320 -30 32 32 0 202
8 0 0 35 0 152 230 16 32 3 205
9 0 0 35 0 407 230 16 32 1 205
10 0 0 35 0 282 43 16 32 4 205
11 0 0 33 1 218 350 32 32 0 202
12 0 0 34 1 360 140 32 32 0 202
13 0 0 33 1 152 150 32 32 0 202