1 5 3 35 -1 310 135 16 32 1 205
2 7 5 35 -1 442 258 16 32 2 205
3 9 5 35 -1 566 258 16 32 2 205
4 11 5 35 -1 696 258 16 32 4 205
5 14 4 35 -1 840 195 16 32 4 205
6 15 5 35 -1 950 292 16 32 2 205
7 17 5 35 -1 1080 292 16 32 4 205
8 19 5 35 -1 1204 258 16 32 2 205
9 21 5 35 -1 1334 258 16 32 11 205
10 23 3 35 -1 1462 164 16 32 5 205

11 23 0 22 -1 1472 0 64 160 0 200
12 23 4 22 -1 1469 255 64 129 0 200
13 22 4 22 -1 1408 223 64 32 0 200
14 21 4 32 -1 1343 286 64 32 0 200
15 19 5 22 -1 1216 319 128 32 0 200
16 17 3 22 -1 1088 191 64 32 0 200
17 15 4 22 -1 959 222 64 32 0 200
18 13 4 22 -1 832 254 64 32 0 200
19 14 5 22 -1 895 319 64 32 0 200
20 15 5 22 -1 960 352 130 32 0 200
21 11 5 22 -1 704 319 64 32 0 200
22 7 3 22 -1 447 191 64 32 0 200
23 5 5 22 -1 320 321 320 32 0 200
24 3 5 22 -1 160 319 33 32 0 200
25 4 3 22 -1 255 190 68 64 0 200
26 0 5 22 -1 0 320 128 64 0 200
27 0 1 22 -1 0 32 64 322 0 200
28 11 5 22 -1 704 351 64 32 0 200

29 2 4 34 -1 85 230 32 32 0 202
30 2 5 33 1 115 315 32 32 0 202
31 4 2 34 1 240 100 32 32 0 202
33 12 5 33 1 750 315 32 32 0 202
34 13 3 34 1 820 165 32 32 0 202
35 20 5 33 -1 1270 317 32 32 0 202
36 18 2 34 -1 1135 100 10 32 0 202
37 23 4 32 0 1515 195 32 32 0 202

38 9 1 148 0 544 63 30 32 0 148
40 14 3 148 0 833 158 30 32 4 148
41 15 2 148 0 960 96 30 32 0 148
42 17 5 148 0 1033 318 30 32 4 148
43 21 5 145 -1 1300 258 40 60 0 145