1 46 8 35 1 1454 262 16 32 6 205
2 42 9 35 1 1330 294 16 32 10 205
3 38 9 35 1 1208 294 16 32 2 205
4 34 9 35 1 1080 294 16 32 9 205
5 30 9 35 1 954 294 16 32 4 205
6 26 9 35 1 824 294 16 32 2 205
7 22 9 35 1 698 294 16 32 2 205
8 18 9 35 1 570 294 16 32 3 205
9 14 9 35 1 440 294 16 32 2 205
10 6 8 35 1 186 264 16 32 4 205
11 10 4 35 1 312 135 16 32 1 205

12 46 0 22 -1 1475 0 60 220 0 200
13 42 10 22 -1 1340 318 196 65 0 200
14 46 0 22 -1 1470 0 66 220 0 200
15 16 0 22 -1 512 0 897 30 0 200
16 26 8 22 -1 831 255 66 32 0 200
17 18 8 22 -1 575 255 66 32 0 200
18 2 8 22 -1 64 255 66 32 0 200
19 8 11 22 -1 254 352 1090 32 0 200
20 4 10 22 -1 126 320 130 32 0 200
21 6 6 22 -1 192 191 194 32 0 200
22 0 1 22 -1 0 32 66 352 0 200
23 0 0 22 -1 0 0 128 32 0 200

24 5 3 33 -1 310 185 32 32 0 202
25 2 0 32 0 95 -30 32 32 0 202

26 42 9 142 -1 1310 288 32 32 2 142
27 27 7 147 0 850 224 30 32 4 147
28 19 7 147 0 590 224 30 32 4 147
29 11 5 147 0 345 162 30 32 4 147
30 2 6 145 0 74 196 40 60 1 145