1 0 0 35 -1 312 156 8 17 1 205
2 0 0 35 -1 443 285 8 17 2 205
3 0 1 35 -1 569 285 8 17 2 205
4 0 1 35 -1 695 285 8 17 4 205
5 0 2 35 -1 839 219 8 17 4 205
6 0 0 35 -1 949 314 8 17 2 205
7 0 0 35 -1 1080 314 8 17 4 205
8 0 1 35 -1 1206 285 8 17 2 205
9 0 1 35 -1 1333 285 8 17 11 205
10 0 2 35 -1 1460 190 8 17 5 205
11 0 0 22 -1 0 360 520 32 0 200
12 0 1 22 -1 520 360 1040 32 0 200
13 0 2 22 -1 1040 360 1536 32 0 200
14 0 2 32 -1 1370 300 50 10 0 202