1 6 8 31 1 167 260 32 64 3 201
2 14 8 31 1 431 260 32 64 1 201
3 22 8 31 1 685 260 32 64 1 201
4 30 8 31 1 930 260 32 64 3 201
5 38 8 31 1 1197 260 32 64 2 201

6 0 10 22 0 0 322 1536 64 0 200

7 22 8 32 0 1400 260 32 64 2 202