1 0 0 22 -1 -320 390 3488 32 0 200
2 0 1 22 -1 520 390 3488 32 0 200
3 0 2 22 -1 1040 390 3488 32 0 200
4 0 3 22 -1 1560 390 3488 32 0 200
5 0 4 22 -1 2080 390 3488 32 0 200
6 0 5 22 -1 2600 390 3488 32 0 200
7 0 6 22 -1 3120 390 3488 32 0 200
8 0 0 35 -1 55 338 0 0 4 201
9 0 2 32 -1 60 310 50 10 0 202