1 3 5 31 -1 167 260 32 64 3 201
2 7 5 31 -1 431 260 32 64 1 201
3 11 5 31 0 685 260 32 64 1 201
4 15 5 31 0 930 260 32 64 3 201
5 19 5 31 0 1197 260 32 64 2 201
6 0 6 22 0 0 322 1536 64 0 200
7 22 5 32 0 1400 260 32 64 0 202
