1 0 0 22 -1 960 0 64 382 0 200
2 0 1 22 -1 895 225 66 30 0 200
3 0 2 22 -1 704 162 192 30 0 200
4 0 3 22 -1 383 162 192 30 0 200
5 0 4 22 -1 190 162 130 30 0 200
6 0 5 22 -1 704 192 62 97 0 200
7 0 6 22 -1 640 288 128 32 0 200
8 0 0 22 -1 575 226 66 30 0 200
9 0 1 22 -1 448 192 95 192 0 200
10 0 2 22 -1 257 192 62 192 0 200
11 0 3 22 -1 128 227 66 30 0 200
12 0 4 22 -1 0 0 32 62 0 200
13 0 5 22 -1 0 163 63 30 0 200
14 0 6 22 -1 0 192 32 192 0 200
15 0 0 35 0 920 34 16 32 2 205
16 0 0 35 0 793 34 16 32 2 205
17 0 0 35 0 663 34 16 32 2 205
18 0 0 35 0 540 34 16 32 2 205
19 0 0 35 0 408 34 16 32 2 205
10 0 0 35 0 284 34 16 32 2 205
21 0 0 35 0 153 34 16 32 2 205
22 0 0 34 0 910 135 32 32 0 202
23 0 0 32 0 -20	95 32 32 0 202