1 6 3 35 1 183 100 16 32 4 205
2 10 5 35 1 313 165 16 32 2 205
3 14 3 35 1 442 100 16 32 2 205
4 2 7 35 1 58 216 16 32 12 205
5 18 9 35 1 568 288 16 32 2 205
6 22 7 35 1 696 227 16 32 11 205
7 26 9 35 1 826 291 16 32 2 205
8 30 9 35 1 954 291 16 32 1 205
9 34 7 35 1 1080 222 16 32 2 205
10 38 9 35 1 1202 291 16 32 4 205
11 42 7 35 1 1335 222 16 32 1 205
12 46 7 35 1 1465 222 16 32 1 205

13 47 0 22 1 1518 0 18 128 0 200
14 47 7 22 1 1510 254 18 90 0 200
15 45 7 22 1 1438 224 98 30 0 200
16 42 9 22 1 1344 286 62 33 0 200
17 0 5 22 1 0 159 222 33 0 200
18 8 7 22 1 256 223 353 33 0 200
19 0 11 22 1 0 356 1536 33 0 200

20 5 4 33 -1 285 220 32 32 0 202
21 4 2 34 -1 210 70 10 32 0 202
22 12 5 33 -1 720 350 32 32 0 202
23 10 3 34 -1 590 135 32 32 0 202
24 22 5 33 1 1355 280 32 32 0 202
25 23 3 34 1 1420 135 32 32 0 202
26 23 3 32 0 1530 160 32 32 0 202

27 4 4 141 1 200 250 40 60 1 141
28 5 4 141 1 300 250 40 60 2 141
29 7 4 141 1 400 250 40 60 3 141