1 0 0 31 -1 167 300 32 64 3 201
2 0 0 31 -1 431 300 32 64 1 201
3 0 1 31 -1 685 300 32 64 1 201
4 0 1 31 -1 930 300 32 64 3 201
5 0 2 31 -1 1197 300 32 64 2 201
6 0 0 22 -1 0 360 520 32 0 200
7 0 1 22 -1 520 360 1040 32 0 200
8 0 2 22 -1 1040 360 1536 32 0 200
9 0 2 32 -1 1270 300 50 10 0 202