1 0 0 35 -1 1454 262 16 32 6 205
2 0 0 35 -1 1337 294 16 32 10 205
3 0 1 35 -1 1208 294 16 32 2 205
4 0 1 35 -1 1080 294 16 32 9 205
5 0 2 35 -1 954 294 16 32 4 205
6 0 0 35 -1 824 294 16 32 2 205
7 0 0 35 -1 698 294 16 32 2 205
8 0 1 35 -1 570 294 16 32 3 205
9 0 1 35 -1 440 294 16 32 2 205
10 0 2 35 -1 186 264 16 32 4 205
11 0 0 35 -1 312 135 16 32 1 205
12 0 0 22 -1 1475 0 60 220 0 200
13 0 1 22 -1 1340 318 196 65 0 200
14 0 2 22 -1 1470 0 66 220 0 200
15 0 2 22 -1 512 0 897 30 0 200
16 0 2 22 -1 831 255 66 32 0 200
17 0 2 22 -1 575 255 66 32 0 200
18 0 2 22 -1 64 255 66 32 0 200
19 0 2 22 -1 254 352 1090 32 0 200
20 0 2 22 -1 126 320 130 32 0 200
21 0 2 22 -1 192 191 194 32 0 200
22 0 2 22 -1 0 32 66 352 0 200
23 0 2 22 -1 0 0 128 32 0 200
24 0 0 33 -1 310 185 32 32 0 202
25 0 0 32 0 95 -30 32 32 0 202