1 0 0 35 -1 310 135 16 32 1 205
2 0 0 35 -1 442 258 16 32 2 205
3 0 1 35 -1 566 258 16 32 2 205
4 0 1 35 -1 696 258 16 32 4 205
5 0 2 35 -1 840 195 16 32 4 205
6 0 0 35 -1 950 292 16 32 2 205
7 0 0 35 -1 1080 292 16 32 4 205
8 0 1 35 -1 1204 258 16 32 2 205
9 0 1 35 -1 1334 258 16 32 11 205
10 0 2 35 -1 1462 164 16 32 5 205
11 0 0 22 -1 1472 0 64 160 0 200
12 0 1 22 -1 1469 255 64 129 0 200
13 0 2 22 -1 1408 223 64 32 0 200
14 0 2 32 -1 1343 286 64 32 0 200
15 0 1 22 -1 1216 319 128 32 0 200
16 0 2 22 -1 1088 191 64 32 0 200
17 0 2 22 -1 959 222 64 32 0 200
18 0 0 22 -1 832 254 64 32 0 200
19 0 1 22 -1 895 319 64 32 0 200
20 0 2 22 -1 960 352 130 32 0 200
21 0 2 22 -1 704 319 64 32 0 200
22 0 1 22 -1 447 191 64 32 0 200
23 0 2 22 -1 320 321 320 32 0 200
24 0 2 22 -1 160 319 33 32 0 200
25 0 1 22 -1 255 190 68 64 0 200
26 0 2 22 -1 0 320 128 64 0 200
27 0 2 22 -1 0 32 64 322 0 200
28 0 2 22 -1 704 351 64 32 0 200
29 0 0 34 0 100 230 32 32 0 202
30 0 0 33 0 105 315 32 32 0 202
31 0 0 34 0 250 100 32 32 0 202
33 0 0 33 0 750 315 32 32 0 202
33 0 0 34 0 820 165 32 32 0 202
34 0 0 33 0 1270 317 32 32 0 202
35 0 0 34 0 1125 100 32 32 0 202
36 0 0 32 0 1515 195 32 32 0 202