1 15 0 22 -1 960 0 64 382 0 200
2 14 3 22 -1 895 225 66 30 0 200
3 11 2 22 -1 704 162 192 30 0 200
4 6 2 22 -1 383 162 192 30 0 200
5 3 2 22 -1 190 162 130 30 0 200
6 11 3 22 -1 704 192 62 97 0 200
7 10 4 22 -1 640 288 128 32 0 200
8 9 3 22 -1 575 226 66 30 0 200
9 7 3 22 -1 448 192 95 192 0 200
10 4 3 22 -1 257 192 62 192 0 200
11 2 3 22 -1 128 227 66 30 0 200
12 0 0 22 -1 0 0 32 62 0 200
13 2 1 22 -1 0 163 63 30 0 200
14 0 3 22 -1 0 192 32 192 0 200
15 14 0 35 0 920 34 16 32 2 205
16 12 0 35 0 793 34 16 32 2 205
17 10 0 35 0 663 34 16 32 2 205
18 8 0 35 0 540 34 16 32 2 205
19 6 0 35 0 408 34 16 32 2 205
10 4 0 35 0 284 34 16 32 2 205
21 2 0 35 0 153 34 16 32 2 205
22 14 2 34 1 910 135 32 32 0 202
23 0 2 32 0 -20	95 32 32 0 202