1 0 0 35 -1 186 122 8 17 4 205
2 0 0 35 -1 59 248 8 17 2 205
3 0 1 35 -1 314 186 8 17 2 205
4 0 1 35 -1 440 122 8 17 12 205
5 0 2 35 -1 570 314 8 17 2 205
6 0 0 35 -1 698 252 8 17 11 205
7 0 0 35 -1 950 314 8 17 2 205
8 0 1 35 -1 1080 252 8 17 1 205
9 0 1 35 -1 1205 314 8 17 2 205
10 0 2 35 -1 1334 252 8 17 4 205
11 0 1 35 -1 1460 252 8 17 1 205
12 0 0 22 -1 0 360 520 32 0 200
13 0 1 22 -1 520 360 1040 32 0 200
14 0 2 22 -1 1040 360 1536 32 0 200
15 0 2 32 -1 1370 300 50 10 0 202