1 0 11 22 0 0 353 512 32 0 200
2 14 0 22 0 450 0 64 384 0 200
3 11 7 22 0 352 225 97 32 0 200
4 2 5 22 0 62 160 256 32 0 200
5 1 4 22 0 32 130 32 124 0 200
6 0 0 22 0 0 0 32 258 0 200

7 	10 	0 32 0 320 -30 32 32 0 202
8 	5 	7 35 1 152 230 16 32 3 205
9 	13 	7 35 1 407 230 16 32 1 205
10 	10 	0 35 1 282 43 16 32 4 205
11 8 5 33 1 200 350 32 32 0 202
12 12 3 34 1 330 140 32 32 0 202
13 6 3 33 1 140 150 32 32 0 202

14 2 1 143 1 82 43 32 32 2 143
15 10 2 144 -1 290 80 30 61 1 144