1 0 11 22 0 0 353 512 32 0 200
2 7 0 22 0 450 0 64 384 0 200
3 5 7 22 0 352 225 97 32 0 200
4 1 5 22 0 62 160 256 32 0 200
5 1 5 22 0 32 130 32 124 0 200
6 0 0 22 0 0 0 32 258 0 200

7 5 0 32 0 320 -30 32 32 0 202
8 4 4 35 0 152 230 16 32 3 205
9 7 4 35 0 407 230 16 32 1 205
10 5 1 35 0 282 43 16 32 4 205
11 4 5 33 1 200 350 32 32 0 202
12 6 3 34 1 330 140 32 32 0 202
13 3 3 33 1 140 150 32 32 0 202

14 2 1 143 1 82 43 32 32 2 143
15 5 2 144 -1 290 80 30 61 1 144