1 0 0 35 -1 310 180 16 32 1 205
2 0 0 35 -1 442 290 16 32 2 205
3 0 1 35 -1 566 290 16 32 2 205
4 0 1 35 -1 696 290 16 32 4 205
5 0 2 35 -1 840 227 16 32 4 205
6 0 0 35 -1 950 324 16 32 2 205
7 0 0 35 -1 1080 324 16 32 4 205
8 0 1 35 -1 1204 290 16 32 2 205
9 0 1 35 -1 1334 290 16 32 11 205
10 0 2 35 -1 1462 196 16 32 5 205
11 0 0 22 -1 1472 157 64 160 0 200
12 0 1 22 -1 1469 384 64 129 0 200
13 0 2 22 -1 1408 255 64 32 0 200
14 0 2 32 -1 1343 318 64 32 0 200
15 0 1 22 -1 1216 351 128 32 0 200
16 0 2 22 -1 1088 223 64 32 0 200
17 0 2 22 -1 959 254 64 32 0 200
18 0 0 22 -1 832 286 64 32 0 200
19 0 1 22 -1 895 351 64 32 0 200
20 0 2 22 -1 960 384 130 32 0 200
21 0 2 22 -1 704 351 64 32 0 200
22 0 1 22 -1 447 223 64 32 0 200
23 0 2 22 -1 320 352 320 32 0 200
24 0 2 22 -1 160 351 33 31 0 200
25 0 1 22 -1 255 254 68 64 0 200
26 0 2 22 -1 0 384 184 64 0 200
27 0 2 22 -1 0 32 64 322 0 200
28 0 2 22 -1 704 351 64 32 0 200