1 0 0 22 -1 -320 380 3488 32 0 200
2 0 1 22 -1 520 380 3488 32 0 200
3 0 2 22 -1 1040 380 3488 32 0 200
4 0 3 22 -1 1560 380 3488 32 0 200
5 0 4 22 -1 2080 380 3488 32 0 200
6 0 5 22 -1 2600 380 3488 32 0 200
7 0 6 22 -1 3120 390 3488 32 0 200
8 0 0 35 0 855 34 8 17 2 205
9 0 0 35 0 727 34 8 17 2 205
10 0 0 35 0 600 34 8 17 2 205
11 0 0 35 0 473 34 8 17 2 205
12 0 0 35 0 343 34 8 17 2 205
13 0 0 35 0 216 34 8 17 2 205
14 0 0 35 0 90 34 8 17 2 205