1 10 4 35 1 310 135 16 32 1 205
2 14 8 35 1 442 258 16 32 2 205
3 18 8 35 1 566 258 16 32 2 205
4 22 8 35 1 696 258 16 32 4 205
5 26 6 35 1 840 195 16 32 4 205
6 30 9 35 1 950 292 16 32 2 205
7 34 9 35 1 1080 292 16 32 4 205
8 38 8 35 1 1204 258 16 32 2 205
9 42 8 35 1 1334 258 16 32 11 205
10 46 5 35 1 1462 164 16 32 5 205

11 46 0 22 1 1472 0 64 160 0 200
12 46 8 22 1 1469 255 64 129 0 200
13 44 7 22 1 1408 223 64 32 0 200
14 42 9 32 1 1343 286 64 32 0 200
15 38 10 22 1 1216 319 128 32 0 200
16 34 6 22 1 1088 191 64 32 0 200
17 30 7 22 1 959 222 64 32 0 200
18 26 8 22 1 832 254 64 32 0 200
19 28 10 22 1 895 319 64 32 0 200
20 30 11 22 1 960 352 130 32 0 200
21 22 10 22 1 704 319 64 32 0 200
22 14 6 22 1 447 191 64 32 0 200
23 10 10 22 1 320 321 320 32 0 200
24 5 10 22 1 160 319 33 32 0 200
25 8 6 22 1 255 190 68 64 0 200
26 0 10 22 1 0 320 128 64 0 200
27 0 0 22 1 0 32 64 322 0 200
28 22 10 22 1 704 351 64 32 0 200

29 2 4 34 1 80 230 32 32 0 202
30 2 5 33 1 115 315 32 32 0 202
31 4 2 34 1 240 100 32 32 0 202
33 12 5 33 1 750 315 32 32 0 202
34 13 3 34 1 820 165 32 32 0 202
35 20 5 33 -1 1270 317 32 32 0 202
36 18 2 34 -1 1135 100 10 32 0 202
37 23 4 32 0 1515 195 32 32 6 202

38 17 2 148 0 544 63 30 32 0 148
40 26 5 148 0 833 158 30 32 4 148
41 30 3 148 0 960 96 30 32 0 148
42 32 10 148 0 1033 318 30 32 4 148
43 41 7 145 -1 1300 258 40 60 0 145